.#####..
#######.
########
#######.
.######.
.######.
.######.
.######.
