......#.
########
#######.
#######.
#######.
#######.
#######.
#######.
