.######..
########.
#########
#########
#########
#########
#########
########.
######.##
