...####..
.#######.
#########
#########
########.
########.
#########
########.
####.#.##
